..#......#....#..#....#.........
..#......#....#..#....#.........
......#..#............#..###....
......####............#..#......
.........#####....#####..#...###
###...................#.........
...............##....####...####
...##...#......##....#......#..
....#...##.....##....#......#..
....#...#.......................
....#...##...............###....
...##...#................#....#.
.............#....#......#...##.
............##....##.....#....#.
...###.....###....###....###...
....#...........................
....#......###....###.....##....
....#.......##....##......##....
...###.......#....#.............
........................#.......
........................#.......
.........#...######...###.......
##...#####............#.........
##.......#............#.........
.........#........###......#####
.........####.......#......#....
.........#..#.......#......#....
......####.................#....
......#.........#####...........
......####......#...#....####...
.........#...............####...
.........#...##.................
