################################
#..............................#
#..............................#
#.......#......#...#...........#
#..............................#
#.....#.......###.....#........#
#.......#.....#................#
#..................#...........#
#.............#................#
#..............................#
#..............................#
#..............................#
#...........########...........#
#...........#......#...........#
#...........#......#...........#
#..............................#
#..............................#
#..............................#
#..............................#
#.............#................#
#..............................#
#..............................#
#...............#..............#
#........#.....................#
#..............................#
#..............................#
#..............................#
#..............................#
#..............................#
#..............................#
#..............................#
################################
